/wiki/White_House	White House
/wiki/Governor-general	Governor-general
/wiki/Committee_for_the_Preservation_of_the_White_House	Committee for the Preservation of the White House
/wiki/Andrea_Palladio	Andrea Palladio
/wiki/Contributing_property	Contributing property
/wiki/White_House_Visitors_Office	White House Visitors Office
/wiki/America%27s_Favorite_Architecture	America's Favorite Architecture
/wiki/The_Metropolitan_Museum_of_Art	The Metropolitan Museum of Art
/wiki/Parliament_Buildings_of_Upper_Canada	Parliament Buildings
/wiki/Double_staircase	double staircase
/wiki/West_Wing	West Wing
/wiki/Panic_of_1873	Panic of 1873
/wiki/Oireachtas	Oireachtas
/wiki/List_of_residences_of_Presidents_of_the_United_States	List of residences of Presidents of the United States
/wiki/Robert_Morris_(financier)	Robert Morris
/wiki/Washington_Monument	Washington Monument
/wiki/Queens%27_Sitting_Room	Queens' Sitting Room
/wiki/Albert_Einstein_Memorial	Albert Einstein
/wiki/Executive_Residence	Executive
Residence
/wiki/Reportedly_haunted_locations_in_Washington,_D.C.#White_House	Reported White House ghosts
/wiki/Rideau_Cottage	Rideau Cottage
/wiki/Attic	attic
/wiki/West_Sitting_Hall	West Sitting Halls
/wiki/Hillary_Clinton	Hillary Clinton
/wiki/Theodore_Roosevelt	Theodore Roosevelt
/wiki/Monarch	Monarch
/wiki/East_Sitting_Hall	East
/wiki/White_House_Fellows	White House Fellows
/wiki/Peace_Corps_Monument	Peace Corps Monument
/wiki/Harry_S._Truman	Harry S. Truman
/wiki/Rainbow_Pool	Rainbow Pool
/wiki/The_Ellipse	the Ellipse
/wiki/Dwight_D._Eisenhower_Memorial	Dwight D. Eisenhower Memorial
/wiki/Winterthur_Museum	Winterthur Museum
/wiki/Aquia_Creek_sandstone	Aquia Creek sandstone
/wiki/Rideau_Hall	Rideau Hall
/wiki/Cabinet_Room_(White_House)	Cabinet Room
/wiki/Malaria	malaria
/wiki/Truman_Balcony	Truman Balcony
/wiki/White_House_Curator	White House Curator
/wiki/John_Plumbe	John Plumbe
/wiki/Office_of_the_First_Lady_of_the_United_States	Office of the First Lady
/wiki/The_Three_Soldiers	The Three Soldiers
/wiki/NASAMS	NASAMS
/wiki/Graphics_and_Calligraphy_Office	Graphics and Calligraphy Office
/wiki/White_House_Visitors_Office	Visitors Office
/wiki/Franklin_D._Roosevelt	Franklin D. Roosevelt
/wiki/Islamic_Center_of_Washington	Islamic Center
/wiki/Green_Room_(White_House)	Green Room
/wiki/Citadelle_of_Quebec	Citadelle of Quebec
/wiki/Oval_Office	Oval Office
/wiki/Boy_Scout_Memorial	Boy Scout
/wiki/Robert_A._Taft_Memorial	Robert A. Taft
/wiki/Blair_House	Blair House
/wiki/Herbert_Hoover	Herbert Hoover
/wiki/John_Ericsson_National_Memorial	John Ericsson
/wiki/Smithsonian_Institution	Smithsonian Institution
/wiki/Blue_Room_(White_House)	Blue Room
/wiki/Vermeil_Room	Vermeil Room
/wiki/American_Revolution_Statuary	American Revolution Statuary
/wiki/National_Liberty_Memorial	National Liberty Memorial
/wiki/Bill_Clinton	Bill Clinton
/wiki/National_Law_Enforcement_Officers_Memorial	Law Enforcement Officers
/wiki/White_House_Social_Secretary	White House Social Secretary
/wiki/Northwest,_Washington,_D.C.	NW Washington, D.C. 20500
/wiki/Yellow_Oval_Room	Yellow Oval Room
/wiki/Treasury_Building_(Washington,_D.C.)	Treasury Building
/wiki/Palladian_architecture	Palladian architecture
/wiki/Tiffany_glass	Tiffany
/wiki/Library_(White_House)	Library
/wiki/Public_auction	public auction
/wiki/Vietnam_Veterans_Memorial	Vietnam Veterans
/wiki/September_11_attacks	September 11 attacks
/wiki/White_House_Situation_Room	Situation Room
/wiki/Second_Division_Memorial	Second Division
/wiki/Upper_Canada	Upper Canada
/wiki/Washington_National_Cathedral	National Cathedral
/wiki/George_Gordon_Meade_Memorial	George Meade
/wiki/Pennsylvania_Avenue	Pennsylvania Avenue
/wiki/%C3%89cole_Sp%C3%A9ciale_d%27Architecture	École Spéciale d'Architecture
/wiki/State_Dining_Room	State Dining Room
/wiki/Adams_Memorial	Adams Memorial
/wiki/Executive_Residence#Third_floor	Third floor
/wiki/Charles_Follen_McKim	Charles McKim
/wiki/East_Sitting_Hall	East Sitting Hall
/wiki/First_Division_Monument	First Division
/wiki/Colonnade	colonnaded
/wiki/H_Street_(Washington,_D.C.)	H Street NW
/wiki/Eisenhower_Executive_Office_Building	Eisenhower Executive Office Building
/wiki/List_of_White_House_security_breaches	List of White House security breaches
/wiki/Jacqueline_Kennedy	Jacqueline Kennedy
/wiki/James_S._Brady_Press_Briefing_Room	James S. Brady Press Briefing Room
/wiki/Wheelchair	wheelchair
/wiki/Henry_Francis_du_Pont	Henry Francis du Pont
/wiki/Lunette	lunette
/wiki/Diplomatic_Reception_Room	Diplomatic Reception Room
/wiki/Harry_S._Truman	Truman
/wiki/Lieutenant-governor	Lieutenant-governor
/wiki/Jacqueline_Kennedy_Garden	Jacqueline Kennedy Garden
/wiki/Theodore_Roosevelt_Island	Theodore Roosevelt Island
/wiki/White_House_Chief_Calligrapher	White House Chief Calligrapher
/wiki/National_Register_of_Historic_Places_architectural_style_categories	Architectural style categories
/wiki/Richard_Nixon	Richard Nixon
/wiki/King%27s_House,_Jamaica	King's House
/wiki/List_of_public_art_in_Washington,_D.C.	Public art in Washington, D.C.
/wiki/Jane_Engelhard	Jane Engelhard
/wiki/American_Veterans_Disabled_for_Life_Memorial	Veterans Disabled for Life
/wiki/National_Archives_Building	National Archives
/wiki/National_World_War_I_Memorial_(Washington,_D.C.)	World War I
/wiki/University_of_Pennsylvania	University of Pennsylvania
/wiki/Frederick_Law_Olmsted,_Jr.	Frederick Law Olmsted, Jr.
/wiki/Queens%27_Bedroom	Queens' Bedroom
/wiki/Gold_leaf	gold leaf
/wiki/Greenhouse	greenhouses
/wiki/Second_Floor_Center_Hall_(White_House)	Center Hall
/wiki/Daniel_Pratt_(eccentric)	Daniel Pratt
/wiki/Charleston,_South_Carolina	Charleston, South Carolina
/wiki/Scotland	Scottish
/wiki/Healy_Hall	Healy Hall
/wiki/Ulysses_S._Grant_Memorial	Ulysses S. Grant
/wiki/Steel_frame	steel frame
/wiki/Basilica_of_the_National_Shrine_of_the_Immaculate_Conception	Immaculate Conception Basilica
/wiki/Prostyle	prostyle portico
/wiki/Thomas_Jefferson	Jefferson
/wiki/National_Heritage_Site_(United_States)	National Heritage Site
/wiki/Franklin_D._Roosevelt%27s_paralytic_illness	his paralytic illness
/wiki/China_Room	China Room
/wiki/Constitution_Avenue	Constitution Avenue
/wiki/Trowbridge_House	Trowbridge House
/wiki/Renaissance	Renaissance
/wiki/Taras_Shevchenko_Memorial	Taras Shevchenko
/wiki/Colonnade	colonnades
/wiki/Oklahoma_City_bombing	Oklahoma City bombing
/wiki/Official_residence	Official government residences
/wiki/Franklin_Delano_Roosevelt_Memorial	Franklin Delano Roosevelt
/wiki/Francis_Marion	General Francis Marion Memorial
/wiki/Jean_Jules_Jusserand	Jean Jules Jusserand
/wiki/One_Observatory_Circle	One Observatory Circle
/wiki/St%C3%A9phane_Boudin	Stéphane Boudin
/wiki/Harrington_Lake	Harrington Lake
/wiki/Samuel_Osgood_House_(New_York_City)	Samuel Osgood House
/wiki/John_McShain	John McShain
/wiki/Outdoor_sculpture_in_Washington,_D.C.	(Outdoor sculpture
/wiki/Memorial_to_the_56_Signers_of_the_Declaration_of_Independence	Signers of the Declaration of Independence
/wiki/Martin_Luther_King,_Jr._Memorial	Martin Luther King, Jr.
/wiki/John_Paul_Jones_Memorial	John Paul Jones
/wiki/American_Elm	American Elm (Ulmus americana L.)
/wiki/Grand_Staircase_(White_House)	Grand Staircase
/wiki/East_Room	East Room
/wiki/White_House_(disambiguation)	White House (disambiguation)
/wiki/President%27s_House_(Philadelphia)	President's House in Philadelphia
/wiki/Zuber_%26_Cie	Zuber & Cie
/wiki/Statue_of_Liberty	Statue of Liberty
/wiki/Old_Executive_Office_Building	Old Executive Office Building
/wiki/HMS_Fantome_(1810)	HMS Fantome
/wiki/British_Army	British Army
/wiki/George_Mason_Memorial	George Mason
/wiki/Los_Pinos	Los Pinos
/wiki/Bordeaux	Bordeaux
/wiki/White_House_Christmas_tree	White House Christmas tree
/wiki/Vitruvius	Vitruvius
/wiki/Executive_Office_of_the_President_of_the_United_States	Executive Office of the President of the United States
/wiki/The_Politico	The Politico
/wiki/Martin_Van_Buren	Martin Van Buren
/wiki/Korean_War_Veterans_Memorial	Korean War Veterans
/wiki/Philadelphia	Philadelphia
/wiki/Treaty_Room	Treaty Room
/wiki/Entrance_Hall	Entrance Hall
/wiki/President_Lincoln%27s_Cottage_at_the_Soldiers%27_Home	Lincoln's Cottage at Soldiers' Home
/wiki/Executive_Residence#State_Floor	State floor
/wiki/East_Wing	East Wing
/wiki/White_House_Office_of_the_Curator	Office of the Curator
/wiki/Map_Room_(White_House)	Map Room
/wiki/James_S._Brady_Press_Briefing_Room	Press Briefing Room
/wiki/The_Ellipse	The Ellipse
/wiki/White_House_Rose_Garden	Rose Garden
/wiki/Lyndon_Baines_Johnson_Memorial_Grove_on_the_Potomac	Lyndon Baines Johnson Grove
/wiki/Government_House,_Fredericton	Old Government House
/wiki/Jefferson_Memorial	Jefferson Memorial
/wiki/United_States_Capitol	Capitol
/wiki/Jayne_Wrightsman	Jayne Wrightsman
/wiki/William_Howard_Taft	William Howard Taft
/wiki/French_Revolution	French Revolution
/wiki/Germantown_White_House	Germantown White House
/wiki/White_House_Chief_Floral_Designer	White House Chief Floral Designer
/wiki/Marine_One	Marine One
/wiki/The_Octagon_House_(Washington,_D.C.)	The Octagon House
/wiki/Jackson_Place	Jackson Place
/wiki/Magnolia_grandiflora	Magnolia grandiflora
/wiki/Charleston_County_Courthouse	Charleston County Courthouse
/wiki/White_House_Reconstruction	White House Reconstruction
/wiki/Neoclassical_architecture	Neoclassical style
/wiki/White_House_Chief_Floral_Designer	Chief Floral Designer
/wiki/Thomas_Jefferson	Thomas Jefferson
/wiki/Chief_Usher_of_the_White_House	Chief Usher
/wiki/Roosevelt_Room	Roosevelt Room
/wiki/Solar_heating	solar water heating panels
/wiki/Memorial_to_Japanese-American_Patriotism_in_World_War_II	Japanese-American Patriotism in World War II
/wiki/List_of_National_Historic_Landmarks_in_Washington,_D.C.	List of National Historic Landmarks in Washington, D.C.
/wiki/Dublin	Dublin
/wiki/Festoon	festoon
/wiki/White_House_Military_Office	White House Military Office
/wiki/White_House_basement	basement
/wiki/24_Sussex_Drive	24 Sussex Drive
/wiki/Ch%C3%A2teau_de_Rastignac	Château de Rastignac
/wiki/Battle_of_York	Battle of York
/wiki/WhiteHouse.gov	WhiteHouse.gov
/wiki/State_Arrival_Ceremony	State Arrival Ceremonies
/wiki/Family_Dining_Room	Family Dining Room
/wiki/The_West_Wing_(TV_series)	The West Wing
/wiki/Abraham_Lincoln	Abraham Lincoln
/wiki/42nd_Floor_Apartment	42nd Floor Apartment
/wiki/Pediment	pediments
/wiki/Ionic_order	Ionic
/wiki/Vietnam_Women%27s_Memorial	Vietnam Women's
/wiki/Parapet	parapet
/wiki/Washington,_D.C.	Washington, D.C.
/wiki/Lincoln_Sitting_Room	Lincoln Sitting Room
/wiki/Porte_cochere	porte cochere
/wiki/LCD	LCD
/wiki/North_Lawn_(White_House)	North Lawn
/wiki/Andrew_Jackson	Andrew Jackson
/wiki/Keeper_of_the_Register	Keeper of the Register
/wiki/African_American_Civil_War_Memorial	African American Civil War
/wiki/James_Monroe	James Monroe
/wiki/Zero_Milestone	Zero Milestone
/wiki/Loggia	loggia
/wiki/Hillary_Rodham_Clinton	Hillary Rodham Clinton
/wiki/Prime_minister	Prime minister
/wiki/Western_White_House	Western White House
/wiki/History_of_the_National_Register_of_Historic_Places	History of the National Register of Historic Places
/wiki/Adams_Memorial_(Saint-Gaudens)	Adams
/wiki/Leinster_House	Leinster House
/wiki/Pennsylvania	Pennsylvania
/wiki/Nathan_C._Wyeth	Nathan C. Wyeth
/wiki/Presidential_Emergency_Operations_Center	Presidential Emergency Operations Center
/wiki/Ionic_Order	Ionic Order
/wiki/Pierre_Charles_L%27Enfant	Pierre Charles L'Enfant
/wiki/Cross_Hall	Cross Hall
/wiki/Daniel_Webster_Memorial	Daniel Webster
/wiki/Emancipation_Memorial	Emancipation
/wiki/Residence_Act	Residence Act
/wiki/Architectural_design_competition	design competition
/wiki/Civil_War_Monuments_in_Washington,_D.C.	Civil War Monuments
/wiki/Whitewash	whitewashed
/wiki/Camp_David	Camp David
/wiki/United_States_Code	United States Code
/wiki/Lincoln_Memorial_Reflecting_Pool	Lincoln Memorial Reflecting Pool
/wiki/National_Register_of_Historic_Places	U.S. National Register of Historic Places
/wiki/Benjamin_Henry_Latrobe	Benjamin Henry Latrobe
/wiki/Louis_Comfort_Tiffany	Louis Comfort Tiffany
/wiki/James_Madison	James Madison
/wiki/Rachel_Lambert_Mellon	Rachel Lambert Mellon
/wiki/Metonymy	metonym
/wiki/Franklin_Roosevelt	Franklin Roosevelt
/wiki/President%27s_Guest_House	President's Guest House
/wiki/Gold_Star_Mothers_National_Monument	Gold Star Mothers Monument
/wiki/United_States_Supreme_Court_Building	Supreme Court Building
/wiki/White_House_Executive_Chef	White House Executive Chef
/wiki/John_F._Kennedy	John F. Kennedy
/wiki/Dordogne	Dordogne
/wiki/Benjamin_Henry_Latrobe	Latrobe
/wiki/White_House_Endowment_Trust	White House Endowment Trust
/wiki/Motorcade	motorcade
/wiki/James_K._Polk	James K. Polk
/wiki/West_Sitting_Hall	West Sitting Hall
/wiki/Meridian_Hill_Park	Meridian Hill
/wiki/National_Palace_(Haiti)	National Palace
/wiki/White_House_Acquisition_Trust	White House Acquisition Trust
/wiki/Pierre_Charles_L%27Enfant	Pierre (Peter) Charles L'Enfant's
/wiki/Olmsted_Brothers	Olmsted Brothers
/wiki/President%27s_Park	President's Park
/wiki/Rosalynn_Carter	Rosalynn Carter
/wiki/American_Civil_War	American Civil War
/wiki/McKim,_Mead_%26_White	McKim, Mead & White
/wiki/Victims_of_Communism_Memorial	Victims of Communism
/wiki/Navy_%E2%80%93_Merchant_Marine_Memorial	Navy - Merchant Marine
/wiki/Ilaro_Court	Ilaro Court
/wiki/1600_Pennsylvania_Avenue_(disambiguation)	1600 Pennsylvania Avenue (disambiguation)
/wiki/United_States_Park_Police	United States Park Police
/wiki/American_Institute_of_Architects	American Institute of Architects
/wiki/Barack_Obama	Barack Obama
/wiki/James_Hoban	James Hoban
/wiki/United_States_Holocaust_Memorial_Museum	Holocaust Museum
/wiki/Laura_Bush	Laura Bush
/wiki/Crowninshield_family	Crowninshield family
/wiki/Caroline_Harrison	Caroline Harrison
/wiki/Lucretia_Garfield	Lucretia Garfield
/wiki/United_States_Air_Force_Memorial	Air Force
/wiki/Fanlight	fanlight
/wiki/Red_Room_(White_House)	Red Room
/wiki/Fiber_optic	fiber optic
/wiki/Grover_Cleveland	Grover Cleveland
/wiki/Pentagon_Memorial	Pentagon
/wiki/President_of_the_United_States	President of the United States
/wiki/Boston_Marathon_Bombings	Boston Marathon Bombings
/wiki/Constitution_Gardens	Constitution Gardens
/wiki/Landmark	Landmarks
/wiki/White_House_Social_Secretary	Social Secretary
/wiki/Alexander_Macomb_House	Alexander Macomb House
/wiki/OpenStreetMap	OpenStreetMap
/wiki/National_Register_of_Historic_Places_listings_in_the_Federated_States_of_Micronesia	Federated States of Micronesia
/wiki/Peace_Monument	Peace Monument
/wiki/Northeastern_University_Press	Northeastern University Press
/wiki/Replicas_of_the_White_House	replicas of the White House
/wiki/Neoclassical_architecture	Neoclassical
/wiki/White_House_Conference_Center	White House Conference Center
/wiki/President_of_Ireland	President of Ireland
/wiki/Number_One_Observatory_Circle	Number One Observatory Circle
/wiki/Presidential_Townhouse	Presidential Townhouse
/wiki/Bill_Clinton	Bill
/wiki/Dwight_D._Eisenhower	Dwight D. Eisenhower
/wiki/Lincoln_Memorial	Lincoln Memorial
/wiki/Executive_Residence#Second_Floor	Second floor
/wiki/White_House_Communications_Agency	White House Communications Agency
/wiki/La_Bachellerie	La Bachellerie
/wiki/John_Adams	John Adams
/wiki/Portico	portico
/wiki/Capitol_Reflecting_Pool	Capitol Reflecting Pool
/wiki/List_of_largest_historic_houses_in_the_United_States	List of largest historic houses in the United States
/wiki/White_House_(plantation)	White House Plantation
/wiki/White_House_Historical_Association	White House Historical Association
/wiki/I_quattro_libri_dell%27architettura	I quattro libri dell'architettura
/wiki/Executive_Residence	Executive Residence
/wiki/Arkansas	Arkansas
/wiki/James_A._Garfield_Monument	James A. Garfield
/wiki/Valentine%27s_Day	Valentine's Day
/wiki/The_Extra_Mile	The Extra Mile
/wiki/Hip_roof	hip roof
/wiki/President%27s_Dining_Room	President's Dining Room
/wiki/Saint_Lucia	Saint Lucia
/wiki/United_States_Secret_Service	United States Secret Service
/wiki/James_Buchanan_Memorial	James Buchanan
/wiki/Lafayette_Square,_Washington,_D.C.	Lafayette Square
/wiki/White_House_Rose_Garden	White House Rose Garden
/wiki/President%27s_Bedroom	President's Bedroom
/wiki/Seven_Buildings	Seven Buildings
/wiki/Jefferson_Pier	Jefferson Pier
/wiki/White_House_History	White House History
/wiki/War_of_1812	War of 1812
/wiki/South_Lawn_(White_House)	South Lawn
/wiki/Government_House,_New_York	Government House, New York
/wiki/Library_of_Congress	Library of Congress
/wiki/George_W._Bush	George W. Bush
/wiki/Burning_of_Washington	Burning of Washington
/wiki/Chester_Arthur	Chester Arthur
/wiki/Pat_Nixon	Pat Nixon
/wiki/First_Lady_of_the_United_States	First Lady
/wiki/Official_residence	official residence
/wiki/Executive_Residence#Ground_Floor	Ground floor
/wiki/Maison_Jansen	House of Jansen
/wiki/National_Park_Service	National Park Service
/wiki/Martha_Washington	Martha Washington
/wiki/Oscar_Straus_Memorial	Oscar Straus
/wiki/White_House_Situation_Room	White House Situation Room
/wiki/World_War_II	World War II
/wiki/New_Executive_Office_Building	New Executive Office Building
/wiki/Lincoln_Bedroom	Lincoln Bedroom
/wiki/Madison_Place	Madison Place
/wiki/Palladian	Palladian
/wiki/Government_House_(Alberta)	Government House
/wiki/September_11_attacks	September 11, 2001
/wiki/Tracery	traceries
